#####
#..*#
#...#
#..##
#.###
#####